7 6
#######
#C    #
#    P#
###  B#
###  G#
#######
