8 7
########
#      #
#  B  P#
###B   #
#   ####
#    GG#
########
