15 14
###############
#    #G  G#   #
#  BB #  #  B #
#   B #  # BB #
#     # B#    #
#   ##G  G##  #
#   #   #     #
##         #  #
## #### ### ###
#   ##G P#G  ##
#   ###  #  BG#
##     B      #
## #  # ## G#G# 
###############
