15 14
###############
#####  ###  G##
#G           ##
####  #### C  #
#        ## GG#
#####G    #####
#   ###      P#
# B #   #######
# B #   #    ##
#   #   #   B##
##  #   #  # ##
#       BB    #
####   #  #   # 
###############
