18 10
##################
#               P#
## ###############
#              BG#
############## ###
#GB              #
################B#
#C               #
#G   B # #GB    G#
##################
