15 14
###############
#            P#
#     B   #####
###B          #
#         G   #
########## ####
#G            #
######   # B  #
#G   #   #  B #
###C ##### ####
###         ###
#G          ###
###        ####
###############
