7 6
#######
#     #
#P 420#
###B  #
###  G#
#######
