7 5
#######
# P   #
#   B##
# B  G#
#######