7 6
#######
#    P#
#P    #
###B  #
###  G#
#######
